date,geography,geography code,Economic activity status: Total: All usual residents aged 16 years and over,Economic activity status: Economically active (excluding full-time students),Economic activity status: Economically active and a full-time student,Number of economically active persons,percentage of economically active persons
2021,Leeds 011A,E01011264,1105,596,15,611,55.29
2021,Leeds 009A,E01011265,1598,972,18,990,61.95
2021,Leeds 008A,E01011266,2108,1437,27,1464,69.45
2021,Leeds 009B,E01011267,1364,778,20,798,58.5
2021,Leeds 010A,E01011268,1100,662,17,679,61.73
2021,Leeds 011B,E01011269,1327,775,19,794,59.83
2021,Leeds 008B,E01011270,1404,778,23,801,57.05
2021,Leeds 009C,E01011271,1710,1075,40,1115,65.2
2021,Leeds 009D,E01011272,1174,722,24,746,63.54
2021,Leeds 010B,E01011273,1245,803,24,827,66.43
2021,Leeds 010C,E01011274,1104,623,32,655,59.33
2021,Leeds 010D,E01011275,1118,660,20,680,60.82
2021,Leeds 011C,E01011276,1443,935,15,950,65.84
2021,Leeds 014A,E01011277,1272,896,26,922,72.48
2021,Leeds 014B,E01011278,1358,892,30,922,67.89
2021,Leeds 008C,E01011279,1088,632,19,651,59.83
2021,Leeds 008D,E01011280,1653,1084,25,1109,67.09
2021,Leeds 059A,E01011281,1722,1110,45,1155,67.07
2021,Leeds 059B,E01011282,1090,655,32,687,63.03
2021,Leeds 059C,E01011283,1121,629,25,654,58.34
2021,Leeds 071A,E01011284,1753,1199,77,1276,72.79
2021,Leeds 059D,E01011286,1056,695,21,716,67.8
2021,Leeds 067B,E01011287,1197,725,25,750,62.66
2021,Leeds 071B,E01011292,1524,822,37,859,56.36
2021,Leeds 071C,E01011293,1484,920,38,958,64.56
2021,Leeds 071D,E01011294,1452,508,21,529,36.43
2021,Leeds 059E,E01011295,1299,858,19,877,67.51
2021,Leeds 030A,E01011296,1403,685,15,700,49.89
2021,Leeds 030B,E01011297,1398,902,21,923,66.02
2021,Leeds 088A,E01011298,1251,745,19,764,61.07
2021,Leeds 088B,E01011299,2174,1491,28,1519,69.87
2021,Leeds 089A,E01011300,1162,685,15,700,60.24
2021,Leeds 089B,E01011301,1058,621,10,631,59.64
2021,Leeds 088C,E01011302,1531,801,21,822,53.69
2021,Leeds 088D,E01011303,953,547,13,560,58.76
2021,Leeds 089C,E01011304,1264,720,25,745,58.94
2021,Leeds 089D,E01011305,1232,834,12,846,68.67
2021,Leeds 089E,E01011306,1093,688,22,710,64.96
2021,Leeds 103A,E01011307,1315,743,22,765,58.17
2021,Leeds 103B,E01011308,1210,728,22,750,61.98
2021,Leeds 030C,E01011309,1251,745,14,759,60.67
2021,Leeds 030D,E01011310,1336,758,20,778,58.23
2021,Leeds 022A,E01011311,1007,602,7,609,60.48
2021,Leeds 086A,E01011312,1416,730,54,784,55.37
2021,Leeds 091A,E01011313,1272,825,39,864,67.92
2021,Leeds 091B,E01011314,1239,816,36,852,68.77
2021,Leeds 090A,E01011315,1260,777,20,797,63.25
2021,Leeds 086B,E01011316,1447,809,54,863,59.64
2021,Leeds 090B,E01011317,1393,733,38,771,55.35
2021,Leeds 090C,E01011318,1123,663,20,683,60.82
2021,Leeds 091C,E01011319,1215,699,37,736,60.58
2021,Leeds 091D,E01011320,1408,862,32,894,63.49
2021,Leeds 090D,E01011321,1240,724,36,760,61.29
2021,Leeds 091E,E01011322,1275,726,21,747,58.59
2021,Leeds 051A,E01011323,1077,620,8,628,58.31
2021,Leeds 046A,E01011324,1438,546,181,727,50.56
2021,Leeds 046B,E01011325,1322,889,17,906,68.53
2021,Leeds 046C,E01011326,1129,673,21,694,61.47
2021,Leeds 052A,E01011327,1098,655,7,662,60.29
2021,Leeds 052B,E01011328,1256,794,21,815,64.89
2021,Leeds 051B,E01011329,1303,854,22,876,67.23
2021,Leeds 051C,E01011330,1106,712,24,736,66.55
2021,Leeds 058A,E01011331,1121,745,26,771,68.78
2021,Leeds 046D,E01011332,1194,685,15,700,58.63
2021,Leeds 051D,E01011333,1097,626,14,640,58.34
2021,Leeds 058B,E01011334,1190,796,25,821,68.99
2021,Leeds 052C,E01011335,1421,959,16,975,68.61
2021,Leeds 058C,E01011336,1328,760,17,777,58.51
2021,Leeds 058D,E01011337,1165,688,31,719,61.72
2021,Leeds 064A,E01011338,1478,813,46,859,58.12
2021,Leeds 060A,E01011339,1602,888,48,936,58.43
2021,Leeds 060B,E01011340,1310,687,40,727,55.5
2021,Leeds 061A,E01011341,1669,1128,24,1152,69.02
2021,Leeds 060C,E01011342,1307,730,30,760,58.15
2021,Leeds 061B,E01011343,1671,1100,36,1136,67.98
2021,Leeds 065A,E01011344,1448,767,42,809,55.87
2021,Leeds 061C,E01011345,1181,696,30,726,61.47
2021,Leeds 060D,E01011346,1454,773,78,851,58.53
2021,Leeds 065B,E01011347,1422,763,31,794,55.84
2021,Leeds 065C,E01011348,1274,731,53,784,61.54
2021,Leeds 065D,E01011349,1429,766,23,789,55.21
2021,Leeds 034A,E01011350,1326,857,24,881,66.44
2021,Leeds 034B,E01011351,1530,1066,25,1091,71.31
2021,Leeds 034C,E01011352,1673,1222,25,1247,74.54
2021,Leeds 034D,E01011353,1625,1167,27,1194,73.48
2021,Leeds 038A,E01011354,1138,665,33,698,61.34
2021,Leeds 038B,E01011355,1177,735,28,763,64.83
2021,Leeds 042A,E01011356,1742,1161,46,1207,69.29
2021,Leeds 038C,E01011357,1585,887,48,935,58.99
2021,Leeds 042B,E01011358,1235,733,25,758,61.38
2021,Leeds 042C,E01011359,1568,984,45,1029,65.63
2021,Leeds 042D,E01011360,1688,866,67,933,55.27
2021,Leeds 042E,E01011361,2186,1161,75,1236,56.54
2021,Leeds 081A,E01011362,1588,1003,35,1038,65.37
2021,Leeds 071E,E01011363,1501,884,39,923,61.49
2021,Leeds 085A,E01011364,1589,977,46,1023,64.38
2021,Leeds 082A,E01011366,1347,815,36,851,63.18
2021,Leeds 082C,E01011368,1233,718,48,766,62.12
2021,Leeds 090E,E01011369,1307,781,22,803,61.44
2021,Leeds 082D,E01011370,1338,750,37,787,58.82
2021,Leeds 085B,E01011371,1356,714,48,762,56.19
2021,Leeds 086C,E01011372,1240,673,82,755,60.89
2021,Leeds 085C,E01011373,1110,641,41,682,61.44
2021,Leeds 085D,E01011374,992,648,40,688,69.35
2021,Leeds 086D,E01011375,1479,801,34,835,56.46
2021,Leeds 013A,E01011376,1348,827,27,854,63.35
2021,Leeds 013B,E01011377,1163,626,17,643,55.29
2021,Leeds 013C,E01011378,1145,582,18,600,52.4
2021,Leeds 017A,E01011379,1257,707,20,727,57.84
2021,Leeds 016A,E01011380,1291,715,18,733,56.78
2021,Leeds 016B,E01011381,1235,667,14,681,55.14
2021,Leeds 013D,E01011382,1326,821,10,831,62.67
2021,Leeds 019A,E01011383,1367,770,16,786,57.5
2021,Leeds 017B,E01011384,1218,705,13,718,58.95
2021,Leeds 016C,E01011385,1120,606,16,622,55.54
2021,Leeds 016D,E01011386,1449,931,27,958,66.11
2021,Leeds 019B,E01011388,1326,755,19,774,58.37
2021,Leeds 087A,E01011390,1138,685,12,697,61.25
2021,Leeds 087B,E01011391,1331,660,14,674,50.64
2021,Leeds 087C,E01011392,1546,934,20,954,61.71
2021,Leeds 103C,E01011393,1754,1182,37,1219,69.5
2021,Leeds 103D,E01011394,971,557,18,575,59.22
2021,Leeds 103E,E01011395,939,642,22,664,70.71
2021,Leeds 074A,E01011396,1581,950,65,1015,64.2
2021,Leeds 077A,E01011397,1211,739,20,759,62.68
2021,Leeds 077B,E01011398,977,621,13,634,64.89
2021,Leeds 074B,E01011399,1235,751,23,774,62.67
2021,Leeds 074C,E01011400,1165,666,22,688,59.06
2021,Leeds 077C,E01011401,1417,902,26,928,65.49
2021,Leeds 087D,E01011402,1738,896,19,915,52.65
2021,Leeds 074D,E01011403,1348,595,27,622,46.14
2021,Leeds 077D,E01011404,1114,676,24,700,62.84
2021,Leeds 077E,E01011405,1266,580,12,592,46.76
2021,Leeds 057A,E01011406,1106,695,18,713,64.47
2021,Leeds 057B,E01011407,1196,736,16,752,62.88
2021,Leeds 057C,E01011408,1332,658,22,680,51.05
2021,Leeds 057D,E01011409,1228,755,30,785,63.93
2021,Leeds 057E,E01011410,1406,814,13,827,58.82
2021,Leeds 073A,E01011411,1436,940,29,969,67.48
2021,Leeds 057F,E01011412,1497,908,25,933,62.32
2021,Leeds 069A,E01011413,1229,803,19,822,66.88
2021,Leeds 073B,E01011414,1262,799,14,813,64.42
2021,Leeds 069B,E01011415,1368,821,35,856,62.57
2021,Leeds 069C,E01011416,1212,799,17,816,67.33
2021,Leeds 069D,E01011417,1338,706,29,735,54.93
2021,Leeds 073C,E01011418,1225,741,23,764,62.37
2021,Leeds 073D,E01011419,973,517,13,530,54.47
2021,Leeds 069E,E01011420,1204,569,17,586,48.67
2021,Leeds 040A,E01011421,1178,638,29,667,56.62
2021,Leeds 048A,E01011422,1259,672,55,727,57.74
2021,Leeds 047A,E01011423,1278,714,37,751,58.76
2021,Leeds 047B,E01011424,1352,759,50,809,59.84
2021,Leeds 040B,E01011425,1211,752,18,770,63.58
2021,Leeds 048B,E01011426,1242,608,72,680,54.75
2021,Leeds 047C,E01011427,1386,700,47,747,53.9
2021,Leeds 048C,E01011428,1540,814,50,864,56.1
2021,Leeds 048D,E01011429,1550,720,60,780,50.32
2021,Leeds 053A,E01011430,1167,581,46,627,53.73
2021,Leeds 047D,E01011431,1587,884,38,922,58.1
2021,Leeds 053B,E01011432,1227,616,35,651,53.06
2021,Leeds 053C,E01011433,1317,703,46,749,56.87
2021,Leeds 053D,E01011434,1192,675,31,706,59.23
2021,Leeds 044A,E01011435,1789,596,405,1001,55.95
2021,Leeds 044D,E01011440,1618,597,353,950,58.71
2021,Leeds 044E,E01011441,1842,662,320,982,53.31
2021,Leeds 110A,E01011442,1808,404,364,768,42.48
2021,Leeds 110B,E01011443,1794,568,308,876,48.83
2021,Leeds 110C,E01011444,1930,308,400,708,36.68
2021,Leeds 054A,E01011445,1743,195,401,596,34.19
2021,Leeds 054B,E01011446,1659,331,361,692,41.71
2021,Leeds 054C,E01011447,1363,248,313,561,41.16
2021,Leeds 054D,E01011448,1565,282,295,577,36.87
2021,Leeds 054E,E01011449,1353,411,274,685,50.63
2021,Leeds 038D,E01011450,1064,611,14,625,58.74
2021,Leeds 110D,E01011451,1452,529,183,712,49.04
2021,Leeds 027A,E01011452,1302,834,26,860,66.05
2021,Leeds 028A,E01011453,1301,797,15,812,62.41
2021,Leeds 027B,E01011454,1267,921,20,941,74.27
2021,Leeds 021A,E01011455,1101,567,50,617,56.04
2021,Leeds 021B,E01011456,1691,765,144,909,53.76
2021,Leeds 027C,E01011457,1296,787,17,804,62.04
2021,Leeds 027D,E01011458,2008,1415,28,1443,71.86
2021,Leeds 021C,E01011459,1408,868,24,892,63.35
2021,Leeds 028B,E01011460,1190,779,18,797,66.97
2021,Leeds 021D,E01011461,1223,693,18,711,58.14
2021,Leeds 028C,E01011462,1355,813,28,841,62.07
2021,Leeds 028D,E01011463,1341,762,23,785,58.54
2021,Leeds 028E,E01011464,1526,1123,39,1162,76.15
2021,Leeds 027E,E01011465,1393,897,23,920,66.04
2021,Leeds 094A,E01011466,1236,690,18,708,57.28
2021,Leeds 112A,E01011467,1605,965,33,998,62.18
2021,Leeds 112B,E01011468,1578,951,36,987,62.55
2021,Leeds 094B,E01011469,1198,705,14,719,60.02
2021,Leeds 112C,E01011470,1047,620,14,634,60.55
2021,Leeds 092A,E01011471,1186,672,33,705,59.44
2021,Leeds 092B,E01011472,1297,691,19,710,54.74
2021,Leeds 092C,E01011473,1113,622,57,679,61.01
2021,Leeds 092D,E01011474,1194,695,26,721,60.39
2021,Leeds 094C,E01011475,1209,709,29,738,61.04
2021,Leeds 094D,E01011476,896,526,18,544,60.71
2021,Leeds 045A,E01011477,1677,1008,92,1100,65.59
2021,Leeds 056A,E01011478,1605,924,192,1116,69.53
2021,Leeds 056B,E01011479,1478,737,242,979,66.24
2021,Leeds 045B,E01011480,1419,819,81,900,63.42
2021,Leeds 056C,E01011481,1608,631,256,887,55.16
2021,Leeds 056D,E01011482,1596,1106,97,1203,75.38
2021,Leeds 056E,E01011483,1436,599,175,774,53.9
2021,Leeds 033A,E01011484,1217,661,21,682,56.04
2021,Leeds 033B,E01011485,1285,744,16,760,59.14
2021,Leeds 045C,E01011488,1281,909,59,968,75.57
2021,Leeds 045D,E01011489,1454,855,61,916,63
2021,Leeds 101A,E01011491,1066,624,29,653,61.26
2021,Leeds 101B,E01011492,1252,703,19,722,57.67
2021,Leeds 101C,E01011493,1194,698,40,738,61.81
2021,Leeds 101D,E01011494,1203,735,29,764,63.51
2021,Leeds 100A,E01011496,1213,890,28,918,75.68
2021,Leeds 101E,E01011497,1221,708,25,733,60.03
2021,Leeds 105D,E01011500,1346,773,17,790,58.69
2021,Leeds 099C,E01011502,1090,645,13,658,60.37
2021,Leeds 032A,E01011504,1214,715,21,736,60.63
2021,Leeds 025A,E01011505,1336,769,24,793,59.36
2021,Leeds 025B,E01011506,1193,739,21,760,63.7
2021,Leeds 025C,E01011507,1309,894,16,910,69.52
2021,Leeds 024A,E01011508,1106,722,20,742,67.09
2021,Leeds 023A,E01011509,1179,647,12,659,55.89
2021,Leeds 025D,E01011510,1267,581,22,603,47.59
2021,Leeds 023B,E01011511,1135,686,28,714,62.91
2021,Leeds 023C,E01011512,1371,877,29,906,66.08
2021,Leeds 031A,E01011513,1782,1246,25,1271,71.32
2021,Leeds 025E,E01011514,1393,920,27,947,67.98
2021,Leeds 023D,E01011515,1231,811,20,831,67.51
2021,Leeds 023E,E01011516,1408,941,16,957,67.97
2021,Leeds 024B,E01011517,1369,896,27,923,67.42
2021,Leeds 093A,E01011518,1852,1334,25,1359,73.38
2021,Leeds 095A,E01011519,1221,744,18,762,62.41
2021,Leeds 096A,E01011520,1270,721,18,739,58.19
2021,Leeds 096B,E01011521,1808,1156,26,1182,65.38
2021,Leeds 095B,E01011522,1153,674,20,694,60.19
2021,Leeds 096C,E01011523,1512,907,24,931,61.57
2021,Leeds 093B,E01011524,1049,658,30,688,65.59
2021,Leeds 095C,E01011525,1261,806,12,818,64.87
2021,Leeds 093C,E01011526,1036,713,30,743,71.72
2021,Leeds 096D,E01011527,1473,849,16,865,58.72
2021,Leeds 095D,E01011528,1294,882,22,904,69.86
2021,Leeds 096E,E01011529,1098,638,22,660,60.11
2021,Leeds 106A,E01011530,1161,708,20,728,62.7
2021,Leeds 093D,E01011531,1432,728,16,744,51.96
2021,Leeds 095E,E01011532,1289,802,18,820,63.62
2021,Leeds 104A,E01011533,1175,787,3,790,67.23
2021,Leeds 106B,E01011534,1822,1344,29,1373,75.36
2021,Leeds 108A,E01011535,1417,815,20,835,58.93
2021,Leeds 108B,E01011536,1382,837,28,865,62.59
2021,Leeds 107A,E01011537,1738,960,22,982,56.5
2021,Leeds 107B,E01011538,1282,739,17,756,58.97
2021,Leeds 102B,E01011540,1558,980,25,1005,64.51
2021,Leeds 104B,E01011541,1844,1040,39,1079,58.51
2021,Leeds 104C,E01011545,1149,734,25,759,66.06
2021,Leeds 106C,E01011546,1390,868,19,887,63.81
2021,Leeds 104D,E01011547,1645,1066,43,1109,67.42
2021,Leeds 106D,E01011548,1210,712,20,732,60.5
2021,Leeds 108C,E01011549,1158,828,22,850,73.4
2021,Leeds 106E,E01011550,1105,726,28,754,68.24
2021,Leeds 107C,E01011551,1385,1016,25,1041,75.16
2021,Leeds 107D,E01011552,1167,655,36,691,59.21
2021,Leeds 108D,E01011553,1151,734,16,750,65.16
2021,Leeds 012A,E01011554,1139,663,20,683,59.96
2021,Leeds 018A,E01011555,1106,642,11,653,59.04
2021,Leeds 015A,E01011556,1357,861,32,893,65.81
2021,Leeds 015B,E01011557,1162,668,23,691,59.47
2021,Leeds 018B,E01011558,1256,712,24,736,58.6
2021,Leeds 018C,E01011559,1099,581,34,615,55.96
2021,Leeds 018D,E01011560,1424,756,20,776,54.49
2021,Leeds 006A,E01011561,1004,622,4,626,62.35
2021,Leeds 012B,E01011562,1303,725,11,736,56.49
2021,Leeds 012C,E01011563,1161,626,14,640,55.12
2021,Leeds 012D,E01011564,1228,747,32,779,63.44
2021,Leeds 015C,E01011565,1161,714,22,736,63.39
2021,Leeds 015D,E01011566,1077,651,8,659,61.19
2021,Leeds 012E,E01011567,1146,709,25,734,64.05
2021,Leeds 015E,E01011568,1579,899,11,910,57.63
2021,Leeds 004A,E01011569,1483,858,23,881,59.41
2021,Leeds 007A,E01011570,1855,1113,34,1147,61.83
2021,Leeds 004B,E01011571,1371,782,23,805,58.72
2021,Leeds 004C,E01011572,1471,927,26,953,64.79
2021,Leeds 004D,E01011573,1056,633,18,651,61.65
2021,Leeds 004E,E01011574,1222,587,16,603,49.35
2021,Leeds 007C,E01011576,1193,711,16,727,60.94
2021,Leeds 011D,E01011578,1086,602,20,622,57.27
2021,Leeds 014C,E01011579,1030,704,14,718,69.71
2021,Leeds 014D,E01011580,1148,661,23,684,59.58
2021,Leeds 003A,E01011581,1359,766,16,782,57.54
2021,Leeds 003B,E01011582,1293,735,25,760,58.78
2021,Leeds 003C,E01011583,1268,769,16,785,61.91
2021,Leeds 003D,E01011584,1377,796,25,821,59.62
2021,Leeds 062A,E01011585,1147,713,26,739,64.43
2021,Leeds 066A,E01011586,1411,872,22,894,63.36
2021,Leeds 062B,E01011587,1396,990,26,1016,72.78
2021,Leeds 039A,E01011588,1384,951,29,980,70.81
2021,Leeds 039B,E01011589,1267,878,24,902,71.19
2021,Leeds 039C,E01011590,1350,806,19,825,61.11
2021,Leeds 052D,E01011591,1425,1031,18,1049,73.61
2021,Leeds 039D,E01011592,1337,891,9,900,67.31
2021,Leeds 039E,E01011593,1603,1072,31,1103,68.81
2021,Leeds 062C,E01011594,1199,766,10,776,64.72
2021,Leeds 066B,E01011595,1743,1044,35,1079,61.9
2021,Leeds 062D,E01011596,1384,932,14,946,68.35
2021,Leeds 066C,E01011597,1307,744,23,767,58.68
2021,Leeds 062E,E01011598,1358,929,32,961,70.77
2021,Leeds 066D,E01011599,1348,891,12,903,66.99
2021,Leeds 079A,E01011600,1293,789,18,807,62.41
2021,Leeds 079B,E01011601,1252,833,16,849,67.81
2021,Leeds 076A,E01011602,1618,915,15,930,57.48
2021,Leeds 076B,E01011603,1305,808,13,821,62.91
2021,Leeds 079C,E01011604,1136,744,17,761,66.99
2021,Leeds 076C,E01011605,1429,873,23,896,62.7
2021,Leeds 076D,E01011606,1593,962,29,991,62.21
2021,Leeds 079D,E01011607,1306,860,27,887,67.92
2021,Leeds 068A,E01011608,1100,649,17,666,60.55
2021,Leeds 068B,E01011609,1141,680,15,695,60.91
2021,Leeds 068C,E01011610,1284,803,29,832,64.8
2021,Leeds 068D,E01011611,1137,667,9,676,59.45
2021,Leeds 079E,E01011612,1234,634,10,644,52.19
2021,Leeds 076E,E01011613,1312,882,11,893,68.06
2021,Leeds 068E,E01011614,1587,1036,27,1063,66.98
2021,Leeds 070A,E01011615,1254,793,17,810,64.59
2021,Leeds 072A,E01011616,1239,698,19,717,57.87
2021,Leeds 070B,E01011617,1254,720,23,743,59.25
2021,Leeds 070C,E01011618,1256,766,36,802,63.85
2021,Leeds 072B,E01011620,991,573,25,598,60.34
2021,Leeds 070D,E01011621,1150,614,40,654,56.87
2021,Leeds 072C,E01011622,1264,711,49,760,60.13
2021,Leeds 075B,E01011623,1259,641,66,707,56.16
2021,Leeds 072D,E01011624,1320,753,40,793,60.08
2021,Leeds 075C,E01011625,1251,746,30,776,62.03
2021,Leeds 075D,E01011626,1850,1210,61,1271,68.7
2021,Leeds 098A,E01011627,1077,572,12,584,54.22
2021,Leeds 098B,E01011628,1068,587,20,607,56.84
2021,Leeds 098C,E01011629,1088,649,13,662,60.85
2021,Leeds 100B,E01011630,1647,1125,21,1146,69.58
2021,Leeds 098D,E01011632,1017,596,17,613,60.28
2021,Leeds 098E,E01011633,1239,724,16,740,59.73
2021,Leeds 100C,E01011634,1282,725,24,749,58.42
2021,Leeds 097B,E01011635,1537,902,27,929,60.44
2021,Leeds 100D,E01011636,1550,911,24,935,60.32
2021,Leeds 097C,E01011637,1364,901,15,916,67.16
2021,Leeds 097D,E01011638,1191,709,20,729,61.21
2021,Leeds 100E,E01011639,1196,673,20,693,57.94
2021,Leeds 032B,E01011641,1247,824,21,845,67.76
2021,Leeds 032C,E01011642,1044,678,23,701,67.15
2021,Leeds 037A,E01011643,1241,665,15,680,54.79
2021,Leeds 037B,E01011644,1046,601,25,626,59.85
2021,Leeds 032D,E01011645,1202,801,12,813,67.64
2021,Leeds 037C,E01011646,1443,874,33,907,62.86
2021,Leeds 037D,E01011647,1423,772,42,814,57.2
2021,Leeds 037E,E01011648,1464,838,49,887,60.59
2021,Leeds 022B,E01011649,1266,739,13,752,59.4
2021,Leeds 020A,E01011650,1180,736,14,750,63.56
2021,Leeds 020B,E01011651,1165,761,30,791,67.9
2021,Leeds 024C,E01011652,1147,736,23,759,66.17
2021,Leeds 020C,E01011653,1157,773,23,796,68.8
2021,Leeds 024D,E01011654,1121,725,22,747,66.64
2021,Leeds 020D,E01011655,1231,720,12,732,59.46
2021,Leeds 035A,E01011656,1126,694,10,704,62.52
2021,Leeds 035B,E01011657,1017,543,17,560,55.06
2021,Leeds 040C,E01011658,1279,710,26,736,57.54
2021,Leeds 035C,E01011659,1131,614,21,635,56.15
2021,Leeds 040D,E01011660,1370,879,24,903,65.91
2021,Leeds 035D,E01011661,1440,617,16,633,43.96
2021,Leeds 040E,E01011662,965,538,33,571,59.17
2021,Leeds 050A,E01011663,1168,721,43,764,65.41
2021,Leeds 050B,E01011664,1028,601,14,615,59.82
2021,Leeds 050C,E01011665,1129,658,10,668,59.17
2021,Leeds 061D,E01011666,1206,755,22,777,64.43
2021,Leeds 050D,E01011667,1047,568,47,615,58.74
2021,Leeds 110E,E01011668,1593,433,355,788,49.47
2021,Leeds 110F,E01011669,1354,504,253,757,55.91
2021,Leeds 055A,E01011670,2215,594,281,875,39.5
2021,Leeds 055B,E01011671,1225,564,74,638,52.08
2021,Leeds 064B,E01011673,1360,758,42,800,58.82
2021,Leeds 064D,E01011677,1261,666,29,695,55.11
2021,Leeds 063B,E01011678,4215,575,962,1537,36.47
2021,Leeds 063D,E01011681,1449,450,196,646,44.58
2021,Leeds 019C,E01011684,1253,754,26,780,62.25
2021,Leeds 109A,E01011685,1898,1099,92,1191,62.75
2021,Leeds 033E,E01011686,1257,668,17,685,54.49
2021,Leeds 109B,E01011687,1234,730,19,749,60.7
2021,Leeds 031B,E01011688,1191,826,27,853,71.62
2021,Leeds 031C,E01011689,1370,899,15,914,66.72
2021,Leeds 109C,E01011690,1193,664,81,745,62.45
2021,Leeds 031D,E01011691,1273,752,51,803,63.08
2021,Leeds 109D,E01011692,1313,860,30,890,67.78
2021,Leeds 109E,E01011693,1357,1015,74,1089,80.25
2021,Leeds 109F,E01011694,1596,889,156,1045,65.48
2021,Leeds 019D,E01011695,1320,692,45,737,55.83
2021,Leeds 006B,E01011696,1278,701,11,712,55.71
2021,Leeds 002A,E01011697,2005,850,32,882,43.99
2021,Leeds 001A,E01011698,1212,706,23,729,60.15
2021,Leeds 001B,E01011699,1100,595,18,613,55.73
2021,Leeds 002B,E01011700,1289,575,11,586,45.46
2021,Leeds 001C,E01011701,1144,628,18,646,56.47
2021,Leeds 001D,E01011702,1323,720,20,740,55.93
2021,Leeds 001E,E01011703,1101,415,13,428,38.87
2021,Leeds 002C,E01011704,1933,964,20,984,50.91
2021,Leeds 002D,E01011705,1138,647,12,659,57.91
2021,Leeds 006C,E01011706,1248,658,18,676,54.17
2021,Leeds 005A,E01011707,1092,555,29,584,53.48
2021,Leeds 006D,E01011708,1212,711,15,726,59.9
2021,Leeds 005B,E01011709,1612,862,27,889,55.15
2021,Leeds 005C,E01011710,1136,681,14,695,61.18
2021,Leeds 005D,E01011711,1197,651,20,671,56.06
2021,Leeds 005E,E01011712,1179,718,19,737,62.51
2021,Leeds 006E,E01011713,1423,831,18,849,59.66
2021,Leeds 029A,E01011714,1510,950,24,974,64.5
2021,Leeds 022C,E01011715,1144,696,21,717,62.67
2021,Leeds 029B,E01011716,1265,755,18,773,61.11
2021,Leeds 029C,E01011717,1303,773,15,788,60.48
2021,Leeds 029D,E01011718,1520,1007,31,1038,68.29
2021,Leeds 022D,E01011719,1222,632,23,655,53.6
2021,Leeds 029E,E01011720,1213,681,19,700,57.71
2021,Leeds 041A,E01011721,1155,705,16,721,62.42
2021,Leeds 041B,E01011722,1588,1029,32,1061,66.81
2021,Leeds 041C,E01011723,1269,692,28,720,56.74
2021,Leeds 041D,E01011724,1445,898,11,909,62.91
2021,Leeds 078A,E01011725,1111,631,36,667,60.04
2021,Leeds 080A,E01011726,1174,697,21,718,61.16
2021,Leeds 080B,E01011727,1278,830,23,853,66.74
2021,Leeds 080C,E01011728,1188,703,23,726,61.11
2021,Leeds 078B,E01011729,1388,804,23,827,59.58
2021,Leeds 078C,E01011730,1151,739,23,762,66.2
2021,Leeds 081B,E01011731,1186,703,22,725,61.13
2021,Leeds 081C,E01011732,1640,1064,20,1084,66.1
2021,Leeds 081D,E01011733,1331,808,24,832,62.51
2021,Leeds 083A,E01011734,2225,1677,37,1714,77.03
2021,Leeds 078D,E01011735,1256,708,25,733,58.36
2021,Leeds 083B,E01011736,1178,736,18,754,64.01
2021,Leeds 083C,E01011737,1245,736,15,751,60.32
2021,Leeds 083D,E01011738,1236,760,23,783,63.35
2021,Leeds 080D,E01011739,1279,724,21,745,58.25
2021,Leeds 097F,E01032487,826,444,18,462,55.93
2021,Leeds 097G,E01032488,1481,881,17,898,60.63
2021,Leeds 102F,E01032489,1720,1291,30,1321,76.8
2021,Leeds 102G,E01032490,1132,792,22,814,71.91
2021,Leeds 102H,E01032491,975,681,19,700,71.79
2021,Leeds 102I,E01032492,1755,1157,39,1196,68.15
2021,Leeds 033F,E01032493,1184,805,7,812,68.58
2021,Leeds 033G,E01032494,1478,887,30,917,62.04
2021,Leeds 105F,E01032496,1761,1236,30,1266,71.89
2021,Leeds 099E,E01032497,1177,691,23,714,60.66
2021,Leeds 099F,E01032498,1382,756,12,768,55.57
2021,Leeds 067G,E01032499,1443,875,33,908,62.92
2021,Leeds 067H,E01032500,1132,685,48,733,64.75
2021,Leeds 017E,E01032501,975,609,7,616,63.18
2021,Leeds 017F,E01032502,1463,917,36,953,65.14
2021,Leeds 007E,E01032503,1195,678,21,699,58.49
2021,Leeds 007F,E01032504,1443,767,22,789,54.68
2021,Leeds 067I,E01032606,1683,1114,21,1135,67.44
2021,Leeds 067J,E01032607,1104,695,20,715,64.76
2021,Leeds 067K,E01032608,963,635,22,657,68.22
2021,Leeds 109G,E01032876,1553,793,83,876,56.41
2021,Leeds 110G,E01032946,3047,686,511,1197,39.28
2021,Leeds 055F,E01033002,1668,915,107,1022,61.27
2021,Leeds 055G,E01033003,1702,993,102,1095,64.34
2021,Leeds 111A,E01033008,2136,461,342,803,37.59
2021,Leeds 111B,E01033010,3477,515,568,1083,31.15
2021,Leeds 111C,E01033011,1315,874,114,988,75.13
2021,Leeds 082E,E01033013,1187,745,49,794,66.89
2021,Leeds 111D,E01033015,1469,1200,48,1248,84.96
2021,Leeds 111E,E01033016,999,791,38,829,82.98
2021,Leeds 075E,E01033021,1770,1141,31,1172,66.21
2021,Leeds 064E,E01033031,1385,812,68,880,63.54
2021,Leeds 075F,E01033033,1500,771,185,956,63.73
2021,Leeds 075G,E01033034,1428,1257,56,1313,91.95
2021,Leeds 064F,E01033035,1181,613,32,645,54.61
2021,Leeds 044G,E01035040,1666,486,453,939,56.36
2021,Leeds 044H,E01035041,1229,400,275,675,54.92
2021,Leeds 055I,E01035042,2143,293,359,652,30.42
2021,Leeds 055J,E01035043,1297,261,256,517,39.86
2021,Leeds 063F,E01035044,2571,350,445,795,30.92
2021,Leeds 063G,E01035045,1251,486,121,607,48.52
2021,Leeds 082G,E01035046,1110,939,50,989,89.1
2021,Leeds 082H,E01035047,1067,774,45,819,76.76
2021,Leeds 099G,E01035048,1461,1072,34,1106,75.7
2021,Leeds 099H,E01035049,1179,924,14,938,79.56
2021,Leeds 105G,E01035050,1170,891,22,913,78.03
2021,Leeds 105H,E01035051,1237,971,33,1004,81.16
2021,Leeds 105I,E01035052,1120,789,18,807,72.05
2021,Leeds 105J,E01035053,1263,972,37,1009,79.89
2021,Leeds 112F,E01035054,2497,1947,108,2055,82.3
